wide range of options - ピンキリ - ピンキリ
narrow, small, confined (narrow-minded, limited) - せまい - 狭い
to make an online purchase - ポチる - ポチる
to memorize - おぼえる - 覚える
to call (the waiter, a taxi) - よぶ - 呼ぶ 
to find - みつける - 見つける
grey - はいいろ - 灰色
violet, purple - むらさき - 紫
silver - ぎんいろ - 銀色
rainbow - にじ - 虹
Jealous - うらやましい - 羨ましい
Reward - ごほうび - ご褒美
Annoying, frustrating, getting on your nerves - イライラ - イライラ
Being mad, angry - おこる - 怒る
Skin - かわ - 皮
Nature - しぜん - 自然
Accuracy (technical) - せいど - 精度
Beach - はまべ - 浜辺
Toy - おもちゃ - おもちゃ
Consider - けんとう - 検討
Chili oil - らーゆ - ラー油
Absorption - きゅうしゅう - 吸収
fresh, refreshing, invigorating - さわやか - 爽やか
Input - にゅうりょく - 入力
Must do (casual more young) - 〜なくちゃ - 〜なくちゃ
Must do (casual, more modern) - 〜ないと - 〜ないと
To mind, to be concerned about - かまう - 構う
No problem, it doesn't matter - かまわない - 構わない
Ticket gate - かいさつ - 改札
Multiple - ふくすう - 複数
